foul	N
narcotic	N
aggression	N
eligible	P
electricity	P
scold	N
hardness	N
tantalizing	P
leisurely	P
elegant	P
resilient	P
unwillingness	N
unfriendly	N
missing	N
stern	N
tardiness	N
insecurity	N
music	P
strike	N
successful	P
hypocritical	N
hurt	N
pointedly	P
wildcat	N
unjust	N
pandemic	N
malign	N
hot	N
beauty	P
modest	P
unselfish	P
effective	P
scourge	N
revolt	N
govern	P
butcher	N
fidelity	P
unexplained	N
fib	N
admirable	P
glorify	P
enrich	P
interrupt	N
spotless	P
solution	P
blinded	N
misfortune	N
unholy	N
encourage	P
adapt	P
outburst	N
speedy	P
disfigured	N
misplace	N
instruct	P
betrothed	P
master	P
shambles	N
wisdom	P
palsy	N
coward	N
pneumonia	N
feeling	N
unintended	N
willingness	P
untrained	N
wholesome	P
responsible	P
imprudent	N
affirmation	P
morality	P
dummy	N
heartily	P
inoperative	N
volatility	N
patch	N
disaster	N
fair	P
unexpectedly	N
result	P
hero	P
scorn	N
extend	P
superficial	N
pity	N
accident	N
obscenity	N
unprotected	N
truthful	P
question	P
muck	N
incompetent	N
suspense	N
prosperity	P
intrusion	N
stillness	N
divination	P
terrific	N
remedial	N
unequivocally	P
subsidence	N
harmoniously	P
seek	P
bottom	N
inhuman	N
creative	P
varicose	N
despair	N
repellent	N
disqualified	N
honeymoon	P
hospice	N
happy	P
offer	P
fascination	P
shoot	N
extremity	N
proud	P
disgrace	N
leer	N
flood	N
vegetative	N
smell	N
twinkle	P
quandary	N
ordination	P
time	P
subvert	N
jarring	N
oversight	N
navigable	P
choice	P
mourn	N
cleanliness	P
falling	N
badge	P
understanding	P
molestation	N
love	P
cacophony	N
prefer	P
logical	P
bloody	N
flagging	N
homesick	N
angry	N
tripping	N
theoretical	P
loving	P
degrade	N
stain	N
preponderance	P
pretend	N
slowness	N
romanticism	P
septic	N
sudden	N
rehabilitate	P
laxative	N
suck	N
truck	P
mange	N
epilepsy	N
unacceptable	N
damage	N
thoughtfulness	P
torn	N
suspicion	N
antipathy	N
syncope	N
investigation	P
magnetite	P
disrespect	N
complicated	N
patronage	P
wrong	N
impure	N
neglect	N
worsening	N
languish	N
wrath	N
prospect	P
mindfulness	P
angina	N
invite	P
unsuitable	N
graciously	P
wanting	N
slump	N
creditable	P
touchy	N
fecal	N
scarce	N
slop	N
outrage	N
dispute	N
prime	P
maniacal	N
worried	N
temperance	P
surgery	N
dysentery	N
alarming	N
forsake	N
verification	P
aberration	N
apparition	N
quack	N
riddle	N
vacation	P
enable	P
surpassing	P
abject	N
profane	N
prominence	P
hypertrophy	N
dubious	N
fame	P
bulletproof	P
scholarship	P
slimy	N
esprit	P
formative	P
dark	N
snarl	N
vague	N
dare	P
malignancy	N
superiority	P
claw	N
stationary	N
wrongly	N
corrosive	N
intimate	P
disparaging	N
prepared	P
homeless	N
wits	P
peaceful	P
dirty	N
reprimand	N
agree	P
rust	N
fright	N
exhausted	N
cathedral	P
seriousness	N
unanimous	P
vivacious	P
infanticide	N
fraudulent	N
weariness	N
sparkle	P
sedition	N
small	N
soundness	P
lobbyist	N
melancholic	N
unchangeable	N
luck	P
sweetness	P
smuggle	N
gorgeous	P
dissident	N
vigorous	P
dislike	N
fatal	N
beautiful	P
allegro	P
proctor	P
disliked	N
glowing	P
waver	N
malevolent	N
thought	P
refuse	N
wrench	N
pang	N
smiling	P
cheerfulness	P
bummer	N
wry	N
sucker	N
recreation	P
misuse	N
disorganized	N
police	P
reproach	N
instigation	N
cyanide	N
ability	P
ethereal	N
peaceable	P
unsafe	N
philanthropy	P
slay	N
saint	P
grace	P
perennial	P
ungrateful	N
marriage	P
uncomfortable	N
caress	P
sprain	N
tough	N
legibility	P
fornication	N
sonnet	P
depression	N
victor	P
virus	N
unequal	N
covet	N
barred	N
artistic	P
barren	N
chowder	P
indifference	N
ordained	P
unpleasant	N
spoiler	N
sunny	P
saturated	N
resent	N
remedy	P
distraction	N
progressive	P
cry	N
outlaw	N
overwhelm	N
urchin	N
hardship	N
incident	N
recherche	P
improved	P
influential	P
approve	P
intestate	N
acceptance	P
rosy	P
sweetheart	P
fire	N
formless	N
inclement	N
uncertain	N
judicial	P
reliable	P
admire	P
error	N
pound	N
agitation	N
vow	P
vanish	N
decoy	N
displeased	N
rabid	N
eager	P
surprised	N
suffering	N
pertinent	P
unrequited	N
mighty	P
amicable	P
wrongful	N
ornate	P
lowly	N
agreement	P
concealed	N
zip	N
wrinkled	N
inspector	P
reverence	P
prodigious	P
poaching	N
submit	P
occupy	P
spat	N
archaic	N
pacific	P
pain	N
charmed	P
slander	N
medical	P
genial	P
graceful	P
hail	P
phantom	N
intact	P
invalid	N
occasional	N
retract	N
tedium	N
scrub	N
energetic	P
suppression	N
worm	N
land	P
merit	P
urgency	N
oracle	P
gossip	N
young	P
abduction	N
obesity	N
sensational	P
mishap	N
unprofitable	N
indestructible	P
eminently	P
unauthorized	N
poverty	N
quaint	P
disobey	N
standing	P
confidence	P
exciting	P
touched	N
shipwreck	N
charity	P
zealous	P
slip	N
martyr	N
educational	P
negation	N
mumps	N
smut	N
reversal	N
perfect	P
decay	N
resentful	N
precaution	P
derelict	N
kiss	P
intelligent	P
delightful	P
truth	P
shortage	N
irritation	N
witness	P
unprepared	N
godly	P
incalculable	N
leukemia	N
embarrass	N
nullify	N
chilly	N
qualifying	P
ethical	P
affliction	N
marrow	P
opportune	P
vixen	N
painful	N
malady	N
ambiguous	N
elite	P
split	N
bother	N
psalm	P
torrent	N
misunderstand	N
ingenious	P
beggar	N
abomination	N
competency	P
bonanza	P
seductive	P
courtesy	P
fiasco	N
fact	P
vacancy	N
principal	P
terminal	N
hope	P
jackpot	P
familiar	P
lucky	P
fraud	N
defenseless	N
smash	N
contemptible	N
yawning	N
explosive	N
absentee	N
galore	P
innocently	P
defiance	N
outsider	N
tyranny	N
hateful	N
fallacious	N
ripe	P
greater	P
denial	N
romance	P
conflicting	N
unsympathetic	N
proficiency	P
overcast	N
snake	N
glum	N
pompous	N
wimpy	N
stagger	N
voluptuous	P
unquestionably	P
slayer	N
cultivated	P
disapproval	N
frustration	N
superhuman	P
count	P
marquis	P
soreness	N
monument	P
rightly	P
rubble	N
renowned	P
deadly	N
suppress	N
reckless	N
ghost	N
torrid	N
villainous	N
unspeakable	N
suicidal	N
desirable	P
integrity	P
onus	N
unanimity	P
perishable	N
disobedient	N
special	P
progression	P
thoughtful	P
refreshing	P
triumph	P
blasphemy	N
voucher	P
established	P
lonesome	N
devastation	N
negative	N
insult	N
worn	N
elbow	N
radiance	P
impair	N
provide	P
morbid	N
fever	N
lax	N
elusive	N
sorrowful	N
greed	N
satisfied	P
sludge	N
respectability	P
harmony	P
unfortunate	N
shameful	N
soak	N
recognizable	P
extrajudicial	N
incongruous	N
pauper	N
prank	N
veto	N
mourning	N
squall	N
maniac	N
truthfulness	P
hamstring	N
opportunity	P
plentiful	P
fumble	N
filibuster	N
happily	P
wasted	N
mercy	P
pessimism	N
enchanted	P
pessimist	N
stomach	N
strength	P
convenient	P
luxury	P
thundering	N
plaintive	N
thresh	N
toilet	N
toast	P
latent	N
uneven	N
retraction	N
degradation	N
frowning	N
nasty	N
slack	N
steal	N
erroneous	N
turmoil	N
damnation	N
gentleman	P
overgrown	N
unable	N
misguided	N
accord	P
malpractice	N
unfold	P
ill	N
stillborn	N
infirm	N
smith	P
tragedy	N
innocent	P
coherent	P
ahead	P
ail	N
abrupt	N
thrash	N
inspired	P
mistake	N
preeminent	P
crowning	P
sting	N
stint	N
confirmed	P
patent	P
raid	N
evil	N
humble	N
salutary	P
musical	P
unpaid	N
athletic	P
victim	N
exalt	P
righteous	P
critique	P
spruce	P
unavoidable	N
noxious	N
elucidate	P
pose	N
herpes	N
hostilities	N
balanced	P
stumble	N
wan	N
undiscovered	N
fight	N
derision	N
playful	P
lowest	N
diligence	P
vitality	P
boon	P
true	P
absent	N
reproductive	P
scrimmage	N
maximum	P
wretched	N
dying	N
shrink	N
polite	P
improvisation	N
grateful	P
idealism	P
pretense	N
terror	N
anonymous	N
forgiving	P
blast	N
feeble	N
prophylactic	P
fragile	N
regret	N
thinker	P
scarcity	N
perplexity	N
helpless	N
tempest	N
inert	N
widow	N
lustrous	P
teacher	P
merriment	P
exemption	P
squeamish	N
extra	P
marked	P
memorable	P
slough	N
misconception	N
purge	N
pitfall	N
parasite	N
abort	N
productive	P
antagonism	N
testament	P
cold	N
unlucky	N
wring	N
inefficiency	N
prick	N
respectable	P
immigrant	N
thirst	N
rational	P
ruinous	N
ominous	N
contemplation	P
invitation	P
blind	N
striking	P
jealousy	N
untrue	N
tragic	N
friend	P
pomp	N
flowery	P
optimism	P
troublesome	N
correction	N
unrest	N
lumpy	N
offering	P
veteran	P
impairment	N
attractiveness	P
startle	N
brunt	N
productivity	P
jolt	N
revulsion	N
famine	N
recalcitrant	N
culpable	N
evict	N
madness	N
foreboding	N
prodigy	P
vagueness	N
soothe	P
trick	N
soil	N
embrace	P
wilderness	N
develop	P
shit	N
constitutional	P
death	N
improvement	P
mournful	N
momentum	P
real	P
miracle	P
perverse	N
throb	N
demonstrative	P
uneasy	N
ugliness	N
innocence	P
testimony	P
inclusion	P
renovate	P
intervention	N
politeness	P
seasoned	P
delayed	N
default	N
sadness	N
gibberish	N
unwelcome	N
completeness	P
woeful	N
esthetic	P
vertigo	N
unitary	P
apathy	N
untidy	N
misnomer	N
pique	N
revoke	N
dreadful	N
reverend	P
passivity	N
confidential	P
traumatic	N
avalanche	N
study	P
vanquish	P
tussle	N
darkness	N
scorching	N
modify	N
heroin	N
teach	P
injure	N
injury	N
blister	N
excuse	N
outstanding	P
stinging	N
reject	N
threat	N
idiocy	N
unsung	N
humbug	N
criticize	N
dread	N
comatose	N
slouch	N
sham	N
hell	N
wishful	P
fruitful	P
absence	N
disclosed	P
pirate	N
fully	P
injured	N
veneration	P
trusty	P
presumptuous	N
unnatural	N
ass	N
reason	P
unsightly	N
dire	N
heroic	P
revolutionary	P
perceptible	P
terrible	N
unaware	N
leading	P
craps	P
perturbation	N
obedience	P
blindly	N
lament	N
affirmative	P
sensual	P
lie	N
evasion	N
superior	P
useless	N
unconstrained	P
threatening	N
promiscuous	N
sturdy	P
mobile	P
popularity	P
clean	P
negligence	N
naturalist	P
hardened	N
upright	P
courteous	P
rheumatism	N
disapproving	N
unpublished	N
culture	P
horrid	N
familiarity	P
woe	N
dank	N
unconscious	N
battery	N
turbulent	N
mumble	N
inadmissible	N
damn	N
threaten	N
crack	N
loon	N
loom	N
brilliant	P
animated	P
riotous	N
grant	P
discredit	N
conflict	N
censure	N
decency	P
royalty	P
consistency	P
savvy	P
unimpressed	N
strife	N
inviting	P
provoking	N
mathematical	P
mucous	N
savage	N
eruption	N
rue	N
subtract	N
shine	P
renewal	P
heritage	P
aftertaste	N
healthful	P
alive	P
sick	N
dull	N
psychosis	N
wicked	N
corrective	P
sullen	N
nag	N
objection	N
theology	P
nay	N
venerable	P
odious	N
heroine	P
cheerful	P
ammonia	N
friendly	P
virtuous	P
uninfected	P
felicity	P
neurotic	N
discouragement	N
nausea	N
stiff	N
compassionate	P
punishing	N
noise	N
ardent	P
nether	N
opaque	N
melancholy	N
weirdo	N
enterprising	P
convert	P
pressure	N
gent	N
benevolence	P
danger	N
apprehensive	N
paranoia	N
remains	N
hydra	N
agreeable	P
depreciate	N
biblical	P
mismatch	N
charming	P
wretch	N
nurture	P
dominant	N
spurious	N
peace	P
canker	N
fatigue	N
insufficient	N
spelling	P
tomb	N
xenophobia	N
alienation	N
placid	P
mastery	P
muff	N
aggravated	N
mar	N
transitional	P
gallant	P
unlawful	N
remiss	N
trashy	N
undo	N
completely	P
sneer	N
corrosion	N
projectile	N
bitch	N
long	P
martyrdom	N
unequivocal	P
spirit	P
attack	N
tramp	N
sardonic	N
torment	N
thorny	N
vengeance	N
upset	N
plague	N
halting	N
grate	N
uninitiated	N
unfinished	N
winner	P
rash	N
quarantine	N
accuser	N
orphan	N
desperate	N
nightmare	N
sorely	N
importance	P
efficiency	P
approval	P
precious	P
problem	N
opposition	N
supreme	P
competent	P
lyrical	P
treat	N
ripen	P
wreck	N
capture	N
forgotten	N
fierce	N
scarcely	N
rife	N
accurate	P
unattached	N
mistaken	N
distress	N
clouded	N
definitive	P
crushed	N
livid	N
engulf	P
immediately	P
loss	N
lost	N
adversity	N
liking	P
grinding	N
inaccurate	N
startling	N
imperfectly	N
misrepresentation	N
exacerbation	N
freedom	P
sinister	N
compatible	P
vulgarity	N
utility	P
rejoice	P
inspiration	P
treacherous	N
evacuate	N
wince	N
grieve	N
sufferer	N
offensive	N
tumble	N
stab	N
pestilence	N
uneducated	N
pardon	P
plenary	P
captain	P
vermin	N
rescue	P
misunderstanding	N
unsuspecting	N
sleek	P
raging	N
laurels	P
convenience	P
enhance	P
subordinate	N
haze	N
refinement	P
credit	P
harass	N
menial	N
inequality	N
undesirable	N
calm	P
recommend	P
survive	P
leaky	N
wary	N
warp	N
worth	P
blight	N
punished	N
loathe	N
stupidity	N
inactivity	N
responsive	P
wickedness	N
personal	P
pleasurable	P
unemployed	N
downright	P
crucial	P
content	P
sluggish	N
revenge	N
struggle	N
naughty	N
peculiarity	P
hood	N
concussion	N
inferno	N
villager	P
anxiety	N
bitterness	N
imputation	N
exorcism	N
hallucination	N
impotent	N
fitting	P
affirmatively	P
don	P
incompatible	N
discontent	N
uneasiness	N
poison	N
divinity	P
hoary	N
cripple	N
morsel	N
perceive	P
slanderous	N
smug	N
illegitimate	N
bad	N
ban	N
attest	P
unworthy	N
fascinating	P
subject	N
inappropriate	N
tantamount	P
unwell	N
witty	P
disorderly	N
resistant	N
distinction	P
commission	P
interest	P
lovely	P
efficacy	P
inattention	N
harshness	N
unpopular	N
ugly	N
defeated	N
shame	N
venom	N
overt	N
weakly	N
romp	P
approbation	P
consciousness	P
auspicious	P
discreet	P
vanity	N
dignity	P
maxim	P
dear	P
strategic	P
uproar	N
unstable	N
bold	P
craftsman	P
marshal	P
intellectual	P
annoyance	N
lurid	N
secondhand	N
immorality	N
failure	N
surrender	N
surprising	N
untitled	N
strengthening	P
classic	P
scientific	P
anthrax	N
mediocre	N
inexplicable	N
answerable	P
tardy	N
insolvency	N
sensuous	P
trepidation	N
overdue	N
skip	N
emeritus	P
appendicitis	N
din	N
nectar	P
die	N
excellence	P
inconsequential	N
sordid	N
deportation	N
wail	N
congestion	N
earthquake	N
boy	N
treasure	P
condescension	N
acceptable	P
unimproved	N
sour	N
crazy	N
ordeal	N
battered	N
stricken	N
strikingly	P
praiseworthy	P
destructive	N
purify	P
cute	P
shaky	N
interesting	P
sterility	N
aching	N
synergistic	P
dissatisfaction	N
possess	P
feverish	N
rock	P
ruffle	N
abnormal	N
weakened	N
smudge	N
advance	P
star	P
exotic	P
bloodshed	N
inefficient	N
illegality	N
mutilation	N
salute	P
endangered	N
interior	P
inept	N
track	P
insanity	N
assault	N
bowels	N
radioactive	N
incisive	P
lowering	N
voodoo	N
precise	P
show	P
stormy	N
plumb	P
black	N
incredulous	N
plump	P
unimportant	N
dignified	P
stupid	N
worrying	N
honesty	P
sear	N
misconduct	N
pained	N
staccato	P
delirium	N
caricature	N
certify	P
sensibly	P
savory	P
disconnected	N
invigorate	P
endowed	P
scavenger	N
pay	P
pad	P
break	N
substantive	P
fume	N
reputable	P
presentable	P
stinking	N
twin	P
miraculous	P
robbery	N
afflict	N
splash	N
ridicule	N
spasm	N
explode	N
broken	N
dastardly	N
smattering	N
fertile	P
blessed	P
compliant	P
hysterical	N
purgatory	N
gory	N
unhappiness	N
gore	N
powerless	N
educated	P
casualty	N
prudent	P
assets	P
weighty	N
growling	N
mug	N
plodding	N
reluctant	N
puffy	N
elated	P
damper	N
portable	P
unthinkable	N
chafing	N
wrecked	N
exasperation	N
tribute	P
falsify	N
malaria	N
promising	P
stupor	N
masterpiece	P
aptitude	P
readily	P
anathema	N
cultivation	P
libel	N
jubilant	P
sincere	P
formality	P
abandon	N
shark	N
share	P
collision	N
minimum	N
obnoxious	N
needy	N
mutable	P
verified	P
deserted	N
setback	N
suffer	N
good	P
frigid	N
exquisite	P
harm	N
seniority	P
cyclone	N
assist	P
disobedience	N
pleasant	P
difficulty	N
audacity	N
uncontrolled	N
unmanageable	N
pop	N
shapely	P
wages	P
construct	P
inconvenient	N
ungodly	N
illiterate	N
sciatica	N
meltdown	N
trip	N
majority	P
humanitarian	P
charitable	P
weigh	P
nobility	P
philanthropic	P
swelling	N
immaturity	N
ruin	N
unhappy	N
fiend	N
intractable	N
permission	P
pristine	P
reading	P
condemnation	N
manly	P
peacock	P
tender	P
forthcoming	P
unacknowledged	N
beautification	P
endocarditis	N
vindicated	P
glorification	P
defunct	N
foreign	N
smother	N
eviction	N
unsuccessful	N
create	P
omniscient	P
intrusive	N
ram	N
gap	N
shoddy	N
starving	N
kill	N
finesse	P
withdraw	N
landmark	P
howl	N
vindictive	N
shape	P
irritable	N
dishonesty	N
cur	N
administrative	P
terrorize	N
confidentially	P
wit	P
senseless	N
invade	N
resolutely	P
patient	P
piles	N
inhumanity	N
graduation	P
misplaced	N
tiff	N
inhospitable	N
indefensible	N
interlocutory	P
devastating	N
constant	P
prevail	P
statement	P
accidental	N
desert	N
riveting	P
vicious	N
blaze	N
nervousness	N
respectful	P
knight	P
shock	N
unsatisfied	N
irreparable	N
repudiation	N
talent	P
contradiction	N
composed	P
limp	N
patrol	P
wondrous	P
insufficiency	N
ashamed	N
unforgiving	N
account	P
obvious	P
praise	P
standstill	N
incompetence	N
trembling	N
considerate	P
criminal	N
skilled	P
infrequent	N
trade	P
kindness	P
frayed	N
estranged	N
immoral	N
sin	N
uninteresting	N
strip	N
insolvent	N
frank	P
indent	P
perjury	N
mortal	N
retain	P
facilitate	P
ancient	N
sadly	N
vulgar	N
hale	P
unscrupulous	N
dreary	N
lover	P
dementia	N
skillful	P
procure	P
kite	N
supported	P
tearful	N
scorpion	N
inferior	N
romantic	P
rage	N
tyrant	N
racket	N
imposition	N
reform	P
laureate	P
routine	P
sorrow	N
freely	P
assure	P
insidious	N
busted	N
teasing	N
commend	P
laugh	P
monstrosity	N
manhood	P
brotherly	P
muddy	N
hellish	N
perplexed	N
received	P
fellow	P
volunteer	P
advisable	P
amenity	P
untoward	N
richness	P
frivolous	N
practice	P
roughness	N
retard	N
excise	N
sanguine	P
ambition	P
judiciary	P
smuggler	N
accessible	P
authority	P
proper	P
stuffy	N
unpredictable	N
discretion	P
combative	N
stellar	P
lieutenant	P
worthy	P
noisy	N
inconsiderate	N
actual	P
purist	P
obliterated	N
chronic	N
esteem	P
wise	P
pig	N
sizzle	N
pickle	N
limited	N
resist	N
frostbite	N
hate	N
poorly	N
therapeutics	P
unsettled	N
gracious	P
divergent	N
risk	N
thriving	P
parrot	N
loneliness	N
enjoy	P
veritable	P
overdo	N
marketable	P
shining	P
hide	N
mischievous	N
wart	N
leprosy	N
discontinuity	N
ulterior	N
represented	P
orthodoxy	P
mentor	P
stray	N
stink	N
patience	P
hospital	N
phony	N
squatter	N
ceremony	P
illicit	N
toxic	N
badly	N
insecure	N
demanding	N
unguarded	N
splendid	P
jungle	N
preventive	N
deform	N
presence	P
sickly	N
hypocrisy	N
destroyed	N
compelling	P
powerful	P
unsupported	N
listless	N
victory	P
probation	N
depress	N
lair	N
fraught	N
god	P
rail	N
acrobat	P
fret	N
correctness	P
tolerant	P
hopeless	N
primary	P
taint	N
isolated	N
elegance	P
contact	P
infliction	N
inexcusable	N
glow	P
constancy	P
rancid	N
orderly	P
entertaining	P
poisonous	N
bait	N
sage	P
disgust	N
reconstruct	P
straits	N
idiotic	N
isolation	N
unwitting	N
upheaval	N
fragrant	P
stunted	N
corrupt	N
depressive	N
rarity	N
mud	N
unconscionable	N
discovery	P
confusion	N
stripped	N
dedication	P
irregular	N
fault	N
suggest	P
untenable	N
trust	P
truss	P
shout	N
confident	P
lesser	N
fallow	N
cracked	N
sincerity	P
brutal	N
surcharge	N
wound	N
saintly	P
misery	N
action	P
unyielding	N
terribly	N
specialize	P
shortly	P
possessed	N
departed	N
sanitary	P
forfeiture	N
humanity	P
verbosity	N
burnt	N
gift	P
zeal	P
stereotype	N
displeasure	N
combat	N
armed	N
intolerant	N
core	P
choke	N
twitch	N
duke	P
civil	P
unpretentious	P
abysmal	N
heal	P
heinous	N
satisfactorily	P
quicksilver	N
adore	P
fury	N
sinful	N
willingly	P
faithful	P
stagnant	N
incestuous	N
uniformly	P
remarkable	P
rob	N
focus	P
rot	N
putative	P
sing	P
advantage	P
gravitate	P
sloppy	N
astringent	N
injunction	N
distaste	N
contracted	N
pleased	P
hairy	N
entertain	P
ply	P
healthy	P
guilty	N
hospitality	P
potable	P
expletive	N
paralyzed	N
crisis	N
symmetrical	P
unwarranted	N
dismay	N
prophecy	P
reflux	N
mortality	N
expectant	P
bigot	N
vital	P
irrational	N
information	P
impartial	P
amuse	P
indecency	N
worship	P
bound	N
qualified	P
obscene	N
lustful	N
occult	N
unproductive	N
hysteria	N
flaccid	N
sweet	P
theory	P
curable	P
visit	P
disillusionment	N
unborn	N
uninspired	N
coming	P
array	P
white	P
hug	P
hurtful	N
copy	N
war	N
mindful	P
oath	P
mislead	N
fracture	N
visitation	N
commonplace	P
betrayal	N
therapeutic	P
horribly	N
trespass	N
superb	P
witch	N
nadir	N
crime	N
partake	P
luxuriant	P
thankful	P
expectation	P
obliterate	N
barbaric	N
unlicensed	N
refine	P
dutiful	P
resentment	N
votive	P
tasteless	N
attentive	P
irrelevant	N
robber	N
pilot	P
unsatisfactory	N
incursion	N
vivid	P
injurious	N
agitated	N
weep	N
minimize	N
relegation	N
relief	P
inability	N
model	P
reward	P
unconstitutional	N
priceless	P
hopeful	P
interested	N
blob	N
confined	N
snort	N
tower	P
joking	P
shortcoming	N
tasteful	P
prolific	P
moot	N
slaughter	N
stalemate	N
tributary	P
wasteful	N
communication	P
weight	N
mischief	N
strongly	P
rejuvenate	P
tasty	P
incorrect	N
loyal	P
manipulate	N
uninvited	N
refractory	N
lace	N
homage	P
present	P
shove	N
awful	N
sentimental	P
advantageous	P
sun	P
whimper	N
overload	N
hopelessness	N
personable	P
thrift	P
paucity	N
extraordinary	P
stiffness	N
flaw	N
mire	N
sorcery	N
varicella	N
trappings	N
unfairness	N
abandonment	N
cultivate	P
court	N
fungus	N
numb	N
replete	P
major	P
bigoted	N
adventurous	P
friendship	P
commemorative	P
musty	N
congenial	P
soulless	N
forgive	P
leverage	P
success	P
probity	P
prejudice	N
unhealthy	N
revive	P
burke	N
prescient	P
storm	N
disqualification	N
boilerplate	N
gutter	N
convinced	P
king	P
kind	P
outrageous	N
stale	N
restful	P
strengthen	P
suspicious	N
shrewd	P
gall	N
insurmountable	N
measured	P
virtue	P
delinquent	N
grotesque	N
penalty	N
hit	N
babble	N
procrastination	N
fallible	N
supporting	P
intelligence	P
bard	P
bark	N
seal	P
forlorn	N
willful	N
degrading	N
fatality	N
whiteness	P
riddled	N
sloth	N
clashing	N
duplicity	N
decline	N
complication	N
sociable	P
demand	N
civility	P
anguish	N
seize	N
negotiate	P
weird	N
lower	N
cheer	P
starved	N
reliance	P
observant	P
theorem	P
reinstate	P
complaint	N
entangled	N
antiseptic	P
litter	N
selfishness	N
stately	P
stingy	N
apathetic	N
lose	N
intense	N
cautious	P
frightful	N
hatred	N
credible	P
conquest	N
usurp	N
motive	P
swamp	N
scrapie	N
warning	N
endurance	P
malicious	N
rightful	P
pervert	N
obstinate	N
stable	P
confirmation	P
lynch	N
unofficial	N
incoherent	N
tenderness	P
friendliness	P
noted	P
malice	N
acid	N
bearish	N
moan	N
unruly	N
delighted	P
giant	N
explore	P
woefully	N
confession	N
procrastinate	N
weeping	N
bitterly	N
clever	P
infection	N
sore	N
disingenuous	N
proof	P
villain	N
spa	P
justifiable	P
fortunate	P
undersized	N
panic	N
tension	N
infantile	N
arduous	N
irregularity	N
mismanagement	N
lifeblood	P
crash	N
negligent	N
deteriorate	N
sob	N
respects	P
chaos	N
honorable	P
frankness	P
scoff	N
usual	P
gospel	P
organic	P
substantiate	P
insane	N
obscurity	N
intuitively	P
wimp	N
unwashed	N
unknown	N
badness	N
shell	N
doomed	N
uninterested	N
objectionable	N
indistinct	N
purification	P
afraid	N
clash	N
harmful	N
discourage	N
longevity	P
chicken	N
feat	P
prosecute	N
ghetto	N
prosperous	P
compliment	P
inventive	P
ogre	N
windfall	P
genius	P
viper	N
trifle	N
spoil	N
profanity	N
retrograde	N
respect	P
unclean	N
decent	P
meritorious	P
sanctify	P
fearful	N
supply	P
mutant	N
disapprove	N
whore	N
exuberance	P
merciful	P
masochism	N
happiness	P
smite	N
helpful	P
incendiary	N
feigned	N
virginity	P
shabby	N
slur	N
worthless	N
fear	N
polished	P
lawful	P
gape	N
uncontrollable	N
shank	N
mutter	N
contradictory	N
rickety	N
goodness	P
dissension	N
